3 8 1921 11325 3180 2138 11208 4198 11226 11198 
2 14 11208 1931 3914 4713 5002 11075 11046 3068 3406 10997 10980 10965 10938 10927 
2 4 11208 11181 11148 11116 
3 4 11208 11247 3351 11324 
2 11 2138 11259 1719 11276 11299 11272 11260 1787 11231 3157 11289 
5 12 11227 3736 11216 1348 1619 11125 3796 4845 11194 4619 5156 1399 
4 21 4845 11118 1026 11076 11035 1215 10946 10913 4849 10895 10860 10826 2530 519 10798 3424 10854 10802 10803 10756 10804 
3 20 10959 1215 2303 4978 10987 11004 246 11059 1191 11051 155 11066 4758 2091 10991 10970 4072 960 4784 10927 
2 6 1399 11156 1882 11113 11094 11066 
4 20 11835 11808 4584 3663 11706 3472 11635 4284 4349 11491 753 11398 1686 11354 3266 3873 11301 2093 11233 11194 
4 18 4845 3702 11256 11273 11302 11340 53 429 4777 11478 11506 11522 11560 11601 11582 3112 11672 11709 
4 17 11301 11336 11372 11384 11417 11456 2537 11540 3097 1677 11616 4034 11708 71 11786 11803 11821 
1 4 11821 4136 3105 11709 
1 3 11616 1156 11601 
1 5 3097 11534 11499 2799 11506 
4 4 11336 11318 2256 11340 
5 10 11340 3816 4665 4061 4457 11319 3152 11290 4070 11257 
1 3 4061 11410 129 
1 4 3816 1835 4192 11251 
1 11 10854 10792 10743 1378 10702 10656 1255 10593 10561 10538 10498 
1 5 10702 10689 3350 817 10666 
2 9 1219 3865 10988 3158 10922 10947 10981 11021 11005 
1 3 10839 10855 10872 
1 8 3895 4901 2830 10452 1284 10519 10523 10498 
1 8 3895 205 4642 10268 10227 10195 3403 10116 
1 69 9921 1877 9836 9808 9798 1439 9710 9670 815 3977 9623 404 2836 9622 5275 5236 3281 9492 9472 9435 9376 9343 9310 1209 3787 9203 459 26 9323 9379 9436 4827 9449 3376 9524 9569 9602 9619 5232 9708 3256 9736 9741 9774 9810 4630 1059 9969 4013 4559 10109 10143 4012 10218 2275 10307 1948 10318 3380 3856 10234 3345 10156 10116 10077 10033 9992 4992 10009 
1 7 1686 3819 4232 3183 11477 11511 635 
1 4 3183 11414 11380 11332 
4 5 11118 4707 2723 11100 246 
1 7 11332 4615 11367 11327 11308 4022 3157 
1 30 10927 10893 3434 10834 10791 10753 4568 10686 1646 5172 10567 10522 10492 4008 2300 10364 10331 2817 10251 1054 10150 110 73 4896 10065 2192 10008 9983 3316 1059 
4 3 11256 11283 2093 
1 2 11318 11283 
1 6 10567 4696 10640 10685 10724 10769 
1 23 10567 1600 10536 2752 10482 10443 1153 4178 1316 10244 998 10186 2270 3500 10112 10071 3758 9982 9954 1466 3851 1800 9790 
1 5 2192 10059 10101 2739 10158 
1 17 73 10162 3927 10281 10317 527 2208 10345 10329 3947 10385 10413 10392 10375 1933 106 1948 
1 17 3947 10402 530 1820 10530 798 10649 10704 10746 609 3725 2945 1147 10921 3218 10951 10970 
1 7 10158 10163 10205 10252 10275 1293 3947 
3 11 10666 10676 2608 956 2710 10726 10777 10824 10859 5176 2945 
1 10 10649 10619 10626 10627 2352 10635 4167 10608 10611 10575 
3 7 10114 3800 655 2605 10324 10298 10327 
1 5 10189 1713 10151 4309 10114 
1 7 10189 10201 5104 10212 10207 10243 3769 
1 11 4309 10047 2659 9956 9922 9880 9847 3541 9802 9764 3885 
1 5 5275 9570 9556 9511 9487 
1 4 9343 9320 9335 9315 
1 6 9315 4913 9344 9321 9309 9316 
1 9 9487 9458 9422 9385 724 9302 1267 3778 4384 
5 16 8674 8759 8810 1650 8914 1544 9031 4998 1217 9201 9232 230 9334 1664 4651 3376 
5 12 9334 2623 3539 9406 9413 9447 3407 4939 2685 9523 9550 1288 
5 4 9523 4564 9466 9399 
5 6 4939 4599 2850 9608 9637 2223 
5 11 9413 9372 2544 9378 3357 9307 9272 263 2714 9173 2260 
3 3 9378 3506 4925 
5 7 9413 9448 9479 5184 2117 2178 9639 
5 5 9201 9233 9265 9286 26 
5 8 230 9256 9255 4467 3609 9240 1193 2260 
5 6 9031 9099 4468 9177 9202 459 
5 28 9031 8995 8951 8950 1195 4311 8841 2231 8728 1772 2200 8528 8475 3142 4339 8564 1617 8674 8709 8749 839 8843 396 8958 9012 9043 9083 4468 
4 7 8950 8988 9039 9105 4023 9184 4467 
3 25 11198 5202 911 11238 11214 11176 11140 11108 1042 11042 954 3667 10916 10892 10849 2995 10736 10694 1128 10659 5165 10684 10646 10612 802 
1 8 1128 4214 10614 3237 10573 5110 10580 349 
1 10 1128 2007 4561 3408 10496 4799 1790 3034 537 10285 
1 8 3034 10363 10350 10341 10328 10304 10257 811 
1 12 811 4432 10264 10259 2545 10209 695 10263 10302 117 10389 5209 
1 5 5209 1082 10558 10603 802 
1 11 1042 11064 3551 11050 11055 3535 11015 11014 10977 4899 1458 
4 19 11214 3435 11285 11322 4374 11404 11428 3686 2554 11550 2818 11633 2205 11687 11716 4161 11788 1148 4307 
1 10 11285 529 11312 11349 1546 4138 5221 11253 11217 2925 
1 8 2925 11174 11206 11213 11254 1844 529 11285 
1 7 4374 11392 11423 5253 11488 11525 11509 
1 14 10976 2412 11010 497 242 10873 10897 4029 10883 163 10827 10787 3040 4767 
2 12 1270 1602 11106 11139 11151 5076 4699 4605 2756 1599 3820 11132 
2 13 11132 11147 11170 4726 3398 4836 11320 11361 4895 2075 2417 11426 11465 
1 5 2075 11386 11416 2473 11357 
1 4 2075 11452 11479 11507 
1 4 11507 11561 4570 11642 
4 11 11507 11528 4174 11557 2299 4105 11579 11584 2094 3315 1799 
1 4 1799 11724 11766 11796 
4 17 11796 11775 11806 11778 383 11819 11846 11865 804 11902 4968 11959 4098 12016 12029 12048 12062 
1 6 10976 2434 11061 5059 4825 11132 
2 17 11642 11692 11749 901 5036 3788 11884 11909 3771 11961 11983 1520 5208 11978 11958 11943 1394 
1 12 242 10903 10863 1828 10808 10818 4323 10822 3253 10750 3221 10672 
1 8 1828 10775 10723 473 2953 10632 1811 746 
5 9 263 9276 9271 9300 1483 4951 9394 1895 9399 
5 15 2260 258 3168 4611 8979 8930 8882 8839 4089 8737 760 8626 8572 8527 8474 
5 61 8581 8575 8538 1549 4912 8488 8520 8537 8494 3641 1941 8382 8327 4280 8387 5098 8276 5114 517 8228 4742 8198 3550 4786 8128 8072 8019 3810 7977 4946 7810 7728 4016 384 7481 7425 2274 7265 1826 7117 7054 6999 6946 6920 1207 6914 6908 6832 6812 6797 6824 6776 6714 4456 1402 6737 6671 6611 2185 6500 4205 
5 15 4317 3155 3545 2381 7535 333 3225 1966 3708 2906 7349 7408 842 2121 96 
5 6 3225 4790 4690 7729 4436 2963 
5 7 3225 7569 1492 1712 4010 7700 1382 
5 19 8581 2115 8439 1226 314 3200 8320 8352 8278 8229 8190 8148 1843 8010 3824 4518 7866 7766 4317 
5 6 4317 7658 7570 2666 4520 3540 
5 6 333 2327 1318 7362 3983 2529 
4 8 333 7426 7361 7283 7220 7196 7138 536 
5 12 4317 2965 7693 3385 7730 1456 2322 7646 7613 7550 7508 7451 
5 20 7451 7452 7382 7315 7329 5167 7212 7232 3694 7158 7095 7037 6979 6958 2643 6859 3767 499 6829 6854 
5 57 3694 7169 7147 4750 2989 2786 3020 6948 6876 6871 6834 1446 6685 6603 6564 2429 6429 6374 6315 4494 6178 2873 6024 5992 5962 1693 4989 6030 6079 6140 6190 6158 6198 4525 3919 6380 2741 6563 6602 6667 6739 6798 6833 1052 6868 6915 4663 6977 6989 1773 4101 4704 7135 7201 2066 7327 3540 
5 40 4205 575 6494 6540 1918 2216 6373 6314 4363 3940 6108 6058 4949 3423 5916 5851 5782 4422 5768 5783 4045 2922 5746 5717 5707 2731 5676 1847 749 5832 3581 4927 5833 1233 5834 233 5878 5841 5889 4989 
3 20 3423 5915 3626 5936 513 5899 5946 6013 6035 5999 5989 1119 3096 6069 6128 6181 4932 6276 6341 3814 
5 13 7451 7528 7625 7682 1448 3367 7929 7973 8035 8097 8160 719 644 
4 9 1456 4582 2507 8001 8058 4653 8230 1609 1226 
5 5 1609 1735 8295 3077 719 
5 16 6854 6830 1140 6783 6792 5053 6716 3375 6689 207 6742 4969 6818 4935 3864 550 
5 36 550 6981 7078 7186 2648 7244 7306 1533 5224 3923 7399 7369 7430 7487 7512 7520 1007 7590 3891 7698 7712 1896 7832 3520 8005 8063 8106 3849 3701 8393 1182 3047 3293 8654 8690 8718 
4 19 1896 2203 7804 1695 863 7853 770 2325 7969 8017 7984 8037 614 8088 8113 8196 8255 947 8355 
1 3 8196 285 1527 
5 24 3694 3488 7317 7252 7286 2261 7428 7469 7435 2912 7615 7648 7751 7828 149 2181 7950 7982 7963 7911 3504 7964 8014 3995 
5 24 3995 1384 8172 3464 2715 3201 8288 3060 4501 8212 3395 8161 8130 8118 8104 8042 8029 8060 3731 8098 8150 8201 5111 644 
5 13 6024 5993 5925 4933 576 5776 2070 5702 4107 5619 5585 5549 3843 
5 18 3375 294 5168 3692 2603 6256 6200 2308 1868 6088 1493 5953 673 5855 2950 5723 5097 5732 
5 14 3995 8144 8069 8036 8021 1634 8053 1077 8174 1408 4773 1075 8390 8474 
4 16 1408 8109 8145 8110 3459 1610 8095 8147 236 5041 8300 8330 8378 3862 8466 3142 
5 16 3459 8054 8022 7957 3119 7863 993 7722 7687 7721 7702 7649 7608 7607 7539 4137 
5 49 6818 6754 4074 6637 6618 6565 3530 2386 2842 6709 2880 860 4489 6891 3491 2575 7041 7098 7109 7141 5030 3536 7343 7331 84 7263 7308 5052 7292 3517 7438 7496 7488 7552 7636 7651 7592 2069 7521 4869 7497 3339 7471 7412 2390 7421 1401 3558 2226 
4 8 4869 7575 859 7704 7771 1438 5263 7938 
5 5 7292 7256 2430 7162 2476 
5 4 2476 2946 6935 2579 
5 20 2579 6883 6894 6904 339 1490 4627 3642 531 6835 6802 6831 6795 6884 6918 6966 6973 7074 7151 2226 
5 19 3530 6458 3878 6321 6257 196 6290 1564 2339 6172 1729 6114 1467 1893 5077 1865 5976 5911 3074 
5 65 7843 4385 7805 7739 7705 2405 4945 1242 2465 7740 4459 7611 7542 7563 1150 1914 4118 7440 7377 7322 1643 7152 7137 3192 7181 7218 3487 1774 7312 7371 7413 7450 7515 681 2895 7653 1540 4463 5144 3416 7807 1201 5060 2548 7925 7986 7924 3304 8038 3867 8137 8138 3831 8316 8349 8398 2384 8485 5196 4158 4909 4291 8294 8301 3177 
1 5 5060 7987 8048 2276 2828 
1 10 1540 7782 7844 7879 7932 3102 3660 8079 8132 2828 
1 14 7932 7961 4684 3942 936 7945 7891 7933 7880 7819 7836 7775 7809 177 
1 5 7775 7764 7707 841 7622 
5 11 7371 7403 4519 7396 7457 15 3666 2665 7404 5175 7357 
3 25 4781 12402 12381 12369 2211 12356 12357 4962 12343 12351 1453 365 12301 3065 12274 12266 12261 12255 12243 12254 12244 1769 4931 12263 12267 
1 4 12243 12247 12237 5227 
1 22 2211 4503 12359 12333 12331 12324 12329 12327 12315 12299 12314 12326 12338 1341 12385 12411 2032 3419 12461 3585 5169 12516 
1 8 3585 12465 12473 12472 1506 12436 12445 12433 
1 3 12385 4002 13343 
4 27 12265 4104 1967 12249 12238 12231 12221 4121 5158 3598 3287 12203 4512 12186 1649 4903 868 4697 1314 12115 12109 3438 12086 3325 12098 12097 13334 
1 11 4697 12129 4143 593 3469 5022 12168 12166 12172 12162 12169 
1 6 12162 12151 12140 12136 12121 1919 
1 7 4143 3673 3606 12052 12035 3755 11999 
1 5 12035 12042 12036 12049 12043 
5 23 3177 1418 8436 755 8586 8648 2690 8713 8767 4021 4479 8933 8990 2767 9104 2584 3348 9117 9096 9054 2002 9020 3364 
1 2 9054 179 
1 3 9054 9068 1681 
1 12 4021 8854 8873 8829 8837 8797 3365 8685 2650 8733 1869 8678 
1 14 8685 8629 8577 8554 5031 3290 4712 4851 8401 2486 3429 8469 3186 8578 
1 3 9054 1419 8983 
1 14 2584 9176 9206 9218 3430 4245 9347 9380 1776 9444 9475 9496 3860 9551 
1 9 9475 5145 9393 9409 9388 5218 9440 3484 9497 
1 17 9218 4730 9207 9169 9187 9158 9182 9198 9170 684 4832 9149 3291 9080 9024 8985 1051 
1 7 1869 8788 3696 8855 8918 789 9023 
3 32 2584 9197 9205 9244 1230 9298 3711 1016 9336 9369 3738 9443 5142 1934 9442 9439 5019 9358 5130 1827 3473 862 9303 9312 186 1464 9215 4417 9144 4224 810 3445 
3 12 5019 9429 9467 9490 2425 9544 997 3756 5271 9716 2827 9800 
1 8 9551 9588 4748 9661 1889 9730 5140 1547 
4 14 5019 2894 1037 9267 3193 9289 555 9292 970 3373 9313 4450 9238 9244 
2 5 3711 9392 9418 9419 1776 
5 17 7615 7673 3494 323 7701 7767 7756 4454 7888 7930 7896 2248 1017 8084 8135 2458 644 
5 11 7896 4612 7778 7685 3583 7684 7614 7572 1496 4005 7451 
5 14 96 7464 1061 4418 3016 1382 3475 7799 7838 7765 2996 7710 2647 4790 
5 8 96 7359 7378 7397 7463 2221 7516 384 
5 28 27 4910 3829 6361 6348 1577 4666 6237 6187 3023 6083 2229 5957 5978 6019 6055 6117 6105 6174 1015 1428 6283 6306 3531 6409 6444 6462 813 
5 12 6795 4533 6729 4106 5125 6554 813 6399 6323 917 6293 1577 
5 5 5957 5921 5191 6056 2463 
5 105 5392 5375 5380 5372 5377 2539 5373 5384 5393 5410 5437 5411 5396 5405 5433 5448 1312 3478 5434 3514 3892 5463 5441 5419 3124 5408 5389 5397 5423 5439 5416 5385 5398 5413 1501 4535 5464 108 2711 5151 5505 5509 5540 5532 5571 5206 1956 4211 5666 5665 5715 403 4890 5736 4588 4516 5809 2973 5639 5594 5615 5597 5564 5577 5545 4715 184 5561 5569 5589 4006 5680 4354 5664 3617 5625 206 5629 3004 5551 5581 5558 5547 5576 5593 5575 5580 5574 4065 4656 5529 5522 5515 5506 5497 3336 5451 5431 5414 5391 5401 308 4961 5376 5370 
1 2 5370 5392 
5 5 8738 8766 4073 8858 8889 
5 6 1242 7898 3076 2977 8025 8070 
5 12 7818 1063 7620 7543 7502 1914 1551 7311 7239 7271 7246 4580 
5 24 2880 6726 6763 6727 6784 6756 200 6855 6820 6764 421 422 6851 6862 6863 3013 6952 7010 7049 7110 7079 2612 7019 2946 
5 9 7135 3553 7056 877 7062 4721 6923 6899 6871 
5 25 6540 6583 6631 4809 6720 6746 1780 6759 3917 2629 277 6738 2747 522 6721 2101 6813 193 1320 6826 2359 6814 2379 4802 6798 
5 25 6314 6307 6296 1349 6351 6418 2439 6365 6419 3319 6477 453 6478 6496 6464 6523 6561 6544 5207 3833 6427 3925 6254 5267 3919 
5 23 4525 1383 6421 1292 6545 6616 6649 2901 2679 6748 6715 4488 6749 6806 6760 796 6858 3794 6827 3326 685 6673 6603 
5 4 7408 7465 7527 4010 
5 10 4690 4272 3294 4541 7904 2971 8034 4186 8117 8148 
5 7 2529 7241 7251 3974 1397 7296 7327 
5 7 536 666 5147 7092 7155 4458 2529 
5 12 536 7055 7043 7000 727 7102 7167 265 7203 7266 7324 96 
5 5 2906 7303 3889 7200 7138 
5 7 7838 2277 7942 8000 3976 8101 4742 
5 6 2963 4853 3195 8159 2456 8327 
5 8 8229 2856 1454 8057 447 8026 4176 4582 
2 5 9436 153 9456 9471 9450 
1 9 9741 1154 4553 9642 9626 9609 9582 4182 414 
3 7 9741 9742 4057 2924 9806 9784 9793 
3 6 9793 3718 912 3554 9985 601 
2 4 601 3650 10066 10109 
4 4 10019 10032 9997 601 
3 5 10019 2923 2936 10194 3345 
1 3 9921 4992 10009 
2 10 780 2343 3760 9805 9782 1692 4976 5008 1800 9790 
1 6 11835 3361 11903 11924 11963 4071 
1 10 2387 11828 2378 11826 11835 11838 11860 11847 11866 11874 
1 3 11821 11857 11874 
1 8 1921 1180 11401 11429 3278 3203 330 11520 
1 5 11520 5219 11588 235 11647 
1 4 635 11596 11615 11647 
1 11 11647 11689 11718 11752 11780 1529 11741 11740 280 11683 11656 
1 3 4719 10144 10114 
1 10 10227 2474 10235 10258 10269 10319 10355 4728 165 3846 
1 7 9487 9488 9482 3807 9538 2951 446 
1 10 446 9514 9527 9532 9519 9563 1372 9577 997 9544 
1 6 785 9438 1648 4473 3233 446 
