3 8 1921 11325 3180 2138 11208 4198 11226 11198 
2 14 11208 1931 3914 4713 5002 11075 11046 3068 3406 10997 10980 10965 10938 10927 
2 4 11208 11181 11148 11116 
3 4 11208 11247 3351 11324 
2 8 2138 11259 1719 11276 11299 1086 11350 11367 
5 9 11227 3736 11216 1348 1619 11125 3796 4845 11194 
4 19 4845 11118 1026 11076 11035 1215 10946 10913 4849 10895 10860 10907 4177 10908 10887 10854 10802 10803 10804 
3 14 10959 1215 2303 4978 10987 11004 246 11059 1191 11051 155 11066 4758 111 
4 13 11835 11808 4584 3663 11706 3472 11635 4284 4349 11491 753 11398 1686 
4 13 11340 53 429 4777 11478 11506 11522 11560 11601 11582 3112 11672 11709 
4 16 11821 11803 11786 71 11708 4034 11616 1677 3097 11540 2537 11456 11417 11384 11372 11336 
1 4 11821 4136 3105 11709 
1 5 3097 11534 11499 2799 11506 
4 4 11336 11318 2256 11340 
5 10 11340 3816 4665 4061 4457 11319 3152 11290 4070 11257 
1 3 4061 11410 129 
2 7 1686 3819 4232 3183 11477 11511 635 
2 5 3183 11414 11378 402 11296 
4 5 11118 4707 2723 11100 246 
2 9 476 11209 3157 11289 11327 11367 4615 11332 11296 
3 30 1059 3316 9983 10008 2192 10065 4896 73 110 10150 1054 10251 2817 10331 10364 2300 4008 10492 10522 10567 5172 1646 10686 4568 10753 10791 10834 54 10893 10927 
2 14 10567 4696 10640 10685 10724 1663 2020 10832 1563 10926 464 602 2664 11116 
1 23 10567 1600 10536 2752 10482 10443 1153 4178 1316 10244 998 10186 2270 3500 10112 10071 3758 9982 9954 1466 3851 1800 9790 
1 5 2192 10059 10101 2739 10158 
3 17 10666 10676 2608 956 2710 10726 10777 10824 10859 5176 10881 2945 10878 10921 3218 10951 10970 
3 7 10114 3800 655 2605 10324 10298 10327 
1 7 10189 10201 5104 10212 10207 10243 3769 
5 19 8674 8759 8810 1650 8914 1544 9031 4998 1217 9201 9232 230 9334 1664 4651 3376 9513 9552 9569 
5 12 9334 2623 3539 9406 9413 9447 3407 4939 2685 9523 9550 1288 
5 4 9523 4564 9466 9399 
5 9 4939 4599 2850 9608 9637 2223 4930 1972 9790 
5 11 9413 9372 2544 9378 3357 9307 9272 263 2714 9173 2260 
3 3 9378 3506 4925 
5 7 9413 9448 9479 5184 2117 2178 9639 
5 5 9201 9233 9265 9286 26 
5 8 230 9256 9255 4467 3609 9240 1193 2260 
5 6 9031 9099 4468 9177 9202 459 
5 28 9031 8995 8951 8950 1195 4311 8841 2231 8728 1772 2200 8528 8475 3142 4339 8564 1617 8674 8709 8749 839 8843 396 8958 9012 9043 9083 4468 
4 7 8950 8988 9039 9105 4023 9184 4467 
3 25 11198 5202 911 11238 11214 11176 11140 11108 1042 11042 954 3667 10916 10892 10849 2995 10736 10694 1128 10659 5165 10684 10646 10612 802 
1 10 1128 2007 4561 3408 10496 4799 1790 3034 537 10285 
1 8 3034 10363 10350 10341 10328 10304 10257 811 
1 12 811 4432 10264 10259 2545 10209 695 10263 10302 117 10389 5209 
1 5 5209 1082 10558 10603 802 
1 11 1042 11064 3551 11050 11055 3535 11015 11014 10977 4899 1458 
4 19 4307 1148 11788 4161 11716 11687 2205 11633 2818 11550 2554 3686 11428 11393 50 4814 11285 3435 11214 
1 15 4767 3040 10787 10827 163 10883 4029 10897 10873 242 497 11010 172 5059 11132 
2 12 1270 1602 11106 11139 11151 5076 4699 4605 2756 1599 3820 11132 
2 14 11132 11147 11170 4726 3398 4836 11320 11361 4895 2075 2417 11426 4270 1523 
1 5 2075 11386 11416 2473 11357 
1 4 2075 11452 11479 11507 
4 11 11507 11528 4174 11557 2299 4105 11579 11584 2094 3315 1799 
1 4 1799 11724 11766 11796 
4 17 11796 11775 11806 11778 383 11819 11846 11865 804 11902 4968 11959 4098 12016 12029 12048 12062 
1 8 1828 10775 10723 473 2953 10632 1811 746 
5 9 263 9276 9271 9300 1483 4951 9394 1895 9399 
5 15 2260 258 3168 4611 8979 8930 8882 8839 4089 8737 760 8626 8572 8527 8474 
5 61 8581 8575 8538 1549 4912 8488 8520 8537 8494 3641 1941 8382 8327 4280 8387 5098 8276 5114 517 8228 4742 8198 3550 4786 8128 8072 8019 3810 7977 4946 7810 7728 4016 384 7481 7425 2274 7265 1826 7117 7054 6999 6946 6920 1207 6914 6908 6832 6812 6797 6824 6776 6714 4456 1402 6737 6671 6611 2185 6500 4205 
5 15 4317 3155 3545 2381 7535 333 3225 1966 3708 2906 7349 7408 842 2121 96 
5 6 3225 4790 4690 7729 4436 2963 
5 7 3225 7569 1492 1712 4010 7700 1382 
5 19 8581 2115 8439 1226 314 3200 8320 8352 8278 8229 8190 8148 1843 8010 3824 4518 7866 7766 4317 
5 6 4317 7658 7570 2666 4520 3540 
5 6 333 2327 1318 7362 3983 2529 
4 8 333 7426 7361 7283 7220 7196 7138 536 
5 12 4317 2965 7693 3385 7730 1456 2322 7646 7613 7550 7508 7451 
5 20 7451 7452 7382 7315 7329 5167 7212 7232 3694 7158 7095 7037 6979 6958 2643 6859 3767 499 6829 6854 
5 57 3694 7169 7147 4750 2989 2786 3020 6948 6876 6871 6834 1446 6685 6603 6564 2429 6429 6374 6315 4494 6178 2873 6024 5992 5962 1693 4989 6030 6079 6140 6190 6158 6198 4525 3919 6380 2741 6563 6602 6667 6739 6798 6833 1052 6868 6915 4663 6977 6989 1773 4101 4704 7135 7201 2066 7327 3540 
5 40 4205 575 6494 6540 1918 2216 6373 6314 4363 3940 6108 6058 4949 3423 5916 5851 5782 4422 5768 5783 4045 2922 5746 5717 5707 2731 5676 1847 749 5832 3581 4927 5833 1233 5834 233 5878 5841 5889 4989 
3 20 3423 5915 3626 5936 513 5899 5946 6013 6035 5999 5989 1119 3096 6069 6128 6181 4932 6276 6341 3814 
5 13 7451 7528 7625 7682 1448 3367 7929 7973 8035 8097 8160 719 644 
4 9 1456 4582 2507 8001 8058 4653 8230 1609 1226 
5 5 1609 1735 8295 3077 719 
5 16 6854 6830 1140 6783 6792 5053 6716 3375 6689 207 6742 4969 6818 4935 3864 550 
5 36 550 6981 7078 7186 2648 7244 7306 1533 5224 3923 7399 7369 7430 7487 7512 7520 1007 7590 3891 7698 7712 1896 7832 3520 8005 8063 8106 3849 3701 8393 1182 3047 3293 8654 8690 8718 
4 19 1896 2203 7804 1695 863 7853 770 2325 7969 8017 7984 8037 614 8088 8113 8196 8255 947 8355 
1 13 8196 285 1527 8274 8242 501 8185 8219 8220 3993 1736 8447 1623 
5 24 3694 3488 7317 7252 7286 2261 7428 7469 7435 2912 7615 7648 7751 7828 149 2181 7950 7982 7963 7911 3504 7964 8014 3995 
5 24 3995 1384 8172 3464 2715 3201 8288 3060 4501 8212 3395 8161 8130 8118 8104 8042 8029 8060 3731 8098 8150 8201 5111 644 
5 13 6024 5993 5925 4933 576 5776 2070 5702 4107 5619 5585 5549 3843 
5 18 3375 294 5168 3692 2603 6256 6200 2308 1868 6088 1493 5953 673 5855 2950 5723 5097 5732 
5 14 3995 8144 8069 8036 8021 1634 8053 1077 8174 1408 4773 1075 8390 8474 
4 16 1408 8109 8145 8110 3459 1610 8095 8147 236 5041 8300 8330 8378 3862 8466 3142 
5 16 3459 8054 8022 7957 3119 7863 993 7722 7687 7721 7702 7649 7608 7607 7539 4137 
5 49 6818 6754 4074 6637 6618 6565 3530 2386 2842 6709 2880 860 4489 6891 3491 2575 7041 7098 7109 7141 5030 3536 7343 7331 84 7263 7308 5052 7292 3517 7438 7496 7488 7552 7636 7651 7592 2069 7521 4869 7497 3339 7471 7412 2390 7421 1401 3558 2226 
4 8 4869 7575 859 7704 7771 1438 5263 7938 
5 5 7292 7256 2430 7162 2476 
5 4 2476 2946 6935 2579 
5 20 2579 6883 6894 6904 339 1490 4627 3642 531 6835 6802 6831 6795 6884 6918 6966 6973 7074 7151 2226 
5 19 3530 6458 3878 6321 6257 196 6290 1564 2339 6172 1729 6114 1467 1893 5077 1865 5976 5911 3074 
5 65 7843 4385 7805 7739 7705 2405 4945 1242 2465 7740 4459 7611 7542 7563 1150 1914 4118 7440 7377 7322 1643 7152 7137 3192 7181 7218 3487 1774 7312 7371 7413 7450 7515 681 2895 7653 1540 4463 5144 3416 7807 1201 5060 2548 7925 7986 7924 3304 8038 3867 8137 8138 3831 8316 8349 8398 2384 8485 5196 4158 4909 4291 8294 8301 3177 
1 5 5060 7987 8048 2276 2828 
2 10 1540 7782 7844 7879 7932 3102 3660 8079 8132 2828 
2 14 7932 7961 4684 3942 936 7945 7891 7933 7880 7819 7836 7775 7809 177 
1 5 7775 7764 7707 841 7622 
5 11 7371 7403 4519 7396 7457 15 3666 2665 7404 5175 7357 
3 25 4781 12402 12381 12369 2211 12356 12357 4962 12343 12351 1453 365 12301 3065 12274 12266 12261 12255 12243 12254 12244 1769 4931 12263 12267 
1 4 12243 12247 12237 5227 
1 22 2211 4503 12359 12333 12331 12324 12329 12327 12315 12299 12314 12326 12338 1341 12385 12411 2032 3419 12461 3585 5169 12516 
1 10 3585 12465 12473 12472 1506 12436 12445 12433 12419 12420 
1 5 12385 4002 13343 12371 12375 
4 29 13334 12097 12098 3325 12086 3438 12109 12115 1314 4697 868 4903 1649 12186 4512 12203 3287 3598 5158 4121 12221 12231 12238 12249 1967 4104 12265 281 12287 
3 11 12162 12172 12166 12168 5022 3469 593 4143 12129 4364 1314 
3 7 12162 12151 12140 12136 12121 2399 232 
2 8 4143 3673 3606 12052 12035 3755 11999 11982 
5 23 3177 1418 8436 755 8586 8648 2690 8713 8767 4021 4479 8933 8990 2767 9104 2584 3348 9117 9096 9054 2002 9020 3364 
1 2 9054 179 
1 3 9054 9068 1681 
1 12 4021 8854 8873 8829 8837 8797 3365 8685 2650 8733 1869 8678 
1 14 8685 8629 8577 8554 5031 3290 4712 4851 8401 2486 3429 8469 3186 8578 
1 3 9054 1419 8983 
3 11 2584 9176 9206 9218 3430 4245 9347 9380 1776 9444 9475 
1 9 9475 5145 9393 9409 9388 5218 9440 3484 9497 
1 16 1051 8985 9024 9080 3291 9149 4832 684 9170 9198 9182 9158 9187 9207 4730 9218 
1 10 1869 8788 3696 8855 8918 789 9023 442 3409 9158 
3 12 5019 9429 9467 9490 2425 9544 997 3756 5271 9716 2827 9800 
2 10 1547 5140 9730 1889 9661 4748 9588 9551 3860 9475 
5 17 7615 7673 3494 323 7701 7767 7756 4454 7888 7930 7896 2248 1017 8084 8135 2458 644 
5 11 7896 4612 7778 7685 3583 7684 7614 7572 1496 4005 7451 
5 14 96 7464 1061 4418 3016 1382 3475 7799 7838 7765 2996 7710 2647 4790 
5 8 96 7359 7378 7397 7463 2221 7516 384 
5 28 27 4910 3829 6361 6348 1577 4666 6237 6187 3023 6083 2229 5957 5978 6019 6055 6117 6105 6174 1015 1428 6283 6306 3531 6409 6444 6462 813 
5 12 6795 4533 6729 4106 5125 6554 813 6399 6323 917 6293 1577 
5 5 5957 5921 5191 6056 2463 
5 105 5392 5375 5380 5372 5377 2539 5373 5384 5393 5410 5437 5411 5396 5405 5433 5448 1312 3478 5434 3514 3892 5463 5441 5419 3124 5408 5389 5397 5423 5439 5416 5385 5398 5413 1501 4535 5464 108 2711 5151 5505 5509 5540 5532 5571 5206 1956 4211 5666 5665 5715 403 4890 5736 4588 4516 5809 2973 5639 5594 5615 5597 5564 5577 5545 4715 184 5561 5569 5589 4006 5680 4354 5664 3617 5625 206 5629 3004 5551 5581 5558 5547 5576 5593 5575 5580 5574 4065 4656 5529 5522 5515 5506 5497 3336 5451 5431 5414 5391 5401 308 4961 5376 5370 
1 2 5370 5392 
5 5 8738 8766 4073 8858 8889 
5 6 1242 7898 3076 2977 8025 8070 
5 12 7818 1063 7620 7543 7502 1914 1551 7311 7239 7271 7246 4580 
5 24 2880 6726 6763 6727 6784 6756 200 6855 6820 6764 421 422 6851 6862 6863 3013 6952 7010 7049 7110 7079 2612 7019 2946 
5 9 7135 3553 7056 877 7062 4721 6923 6899 6871 
5 25 6540 6583 6631 4809 6720 6746 1780 6759 3917 2629 277 6738 2747 522 6721 2101 6813 193 1320 6826 2359 6814 2379 4802 6798 
5 25 6314 6307 6296 1349 6351 6418 2439 6365 6419 3319 6477 453 6478 6496 6464 6523 6561 6544 5207 3833 6427 3925 6254 5267 3919 
5 23 4525 1383 6421 1292 6545 6616 6649 2901 2679 6748 6715 4488 6749 6806 6760 796 6858 3794 6827 3326 685 6673 6603 
5 4 7408 7465 7527 4010 
5 10 4690 4272 3294 4541 7904 2971 8034 4186 8117 8148 
5 7 2529 7241 7251 3974 1397 7296 7327 
5 7 536 666 5147 7092 7155 4458 2529 
5 12 536 7055 7043 7000 727 7102 7167 265 7203 7266 7324 96 
5 5 2906 7303 3889 7200 7138 
5 7 7838 2277 7942 8000 3976 8101 4742 
5 6 2963 4853 3195 8159 2456 8327 
5 8 8229 2856 1454 8057 447 8026 4176 4582 
3 8 9450 9471 9456 153 9436 4827 9449 3376 
1 9 9741 1154 4553 9642 9626 9609 9582 4182 414 
3 7 9741 9742 4057 2924 9806 9784 9793 
3 6 9793 3718 912 3554 9985 601 
2 9 601 3650 10066 10109 3658 2207 10164 10163 10158 
4 4 10019 10032 9997 601 
2 14 9790 1800 5008 4976 1692 9782 9805 3760 2343 780 9817 304 9763 9741 
1 6 11835 3361 11903 11924 11963 4071 
1 10 2387 11828 2378 11826 11835 11838 11860 11847 11866 11874 
1 3 11821 11857 11874 
1 8 1921 1180 11401 11429 3278 3203 330 11520 
1 5 11520 5219 11588 235 11647 
1 4 635 11596 11615 11647 
1 11 11647 11689 11718 11752 11780 1529 11741 11740 280 11683 11656 
1 3 4719 10144 10114 
1 7 9487 9488 9482 3807 9538 2951 446 
1 10 446 9514 9527 9532 9519 9563 1372 9577 997 9544 
1 3 11073 11127 1270 
1 3 11073 244 4899 
1 4 10916 10899 10869 433 
1 5 433 10831 10789 10745 1635 
1 4 1635 10615 10580 349 
1 3 296 1955 10684 
1 4 11633 11680 3143 138 
1 3 11902 11917 340 
1 3 340 11853 4307 
1 7 2925 11174 11206 11254 1844 529 11285 
1 8 4766 899 1546 4138 5221 11253 11217 2925 
1 6 11448 3121 11411 11390 5192 11357 
1 4 2925 2877 1706 11055 
1 6 11799 11804 11795 11781 11764 11749 
1 9 11799 1524 11848 2730 11897 11925 2253 11974 11980 
1 13 11980 2232 18154 18172 18171 18153 18138 18142 18111 18070 18048 18066 18065 
1 5 18048 18035 18038 18049 18039 
1 5 18039 18010 17990 17985 17950 
1 6 17950 17959 17928 17897 17851 17813 
1 12 17950 17997 18042 18083 12075 4870 2445 12039 12023 2807 1647 11974 
1 7 18065 18033 18055 18064 18059 18069 18046 
1 13 18070 18110 18147 18179 18231 18275 18294 18315 18376 18414 18444 18458 18445 
1 10 18035 18006 17994 17958 17946 17922 17882 17868 17864 17874 
1 6 18261 18228 18229 18277 18306 18315 
1 12 17922 17967 17973 17979 17949 17936 17917 17926 17914 17876 17899 17886 
1 11 18156 18182 18206 18219 18216 18189 18211 18207 18203 18236 18261 
1 14 17950 17934 17896 17879 17889 17855 17805 17769 17736 17692 17646 17612 17616 17596 
1 6 17896 17875 17834 17790 17762 17755 
1 6 3788 1682 3648 11970 11994 1608 
1 14 18786 11199 11195 11200 1171 11228 11236 2140 2060 40 4060 11131 4825 11132 
1 3 10269 10200 4719 
3 11 1284 10472 10477 10498 1594 10593 10606 10641 10682 3707 10802 
1 4 10189 1713 10151 3800 
1 11 10298 10327 10320 10332 2317 4249 2660 10347 10310 10291 10243 
1 5 10114 4309 1863 3132 9986 
1 6 9986 3903 9922 9880 9847 3541 
1 9 9986 3653 10020 10034 4644 10136 3403 10195 3345 
1 8 11656 3139 11581 11563 11526 11494 4171 11429 
5 6 11336 4900 11283 11256 11233 11194 
1 4 4061 11328 11306 11277 
1 6 1520 2033 12051 12069 4862 549 
1 4 1520 11965 11951 534 
1 3 1394 11943 534 
1 7 10672 3221 104 2754 10818 10808 1828 
1 4 1828 10863 3644 242 
1 4 3788 5036 901 11749 
1 3 11749 11733 2563 
1 4 2563 11654 3775 4174 
1 8 3788 11884 393 5127 11916 11939 11919 534 
1 9 9482 4226 9428 1457 785 9352 9357 9329 186 
3 7 10019 17 22 32 25 10156 3345 
3 9 3345 1012 10323 205 797 10428 10439 10471 1284 
1 7 10269 10258 10282 2474 10268 10242 3345 
1 8 287 10382 2054 10437 173 10406 1573 3947 
1 5 829 10354 10331 10338 287 
1 6 1059 9938 3089 3457 2586 304 
2 6 3947 10329 10293 10252 10225 10158 
3 4 10666 354 2396 1284 
3 5 10895 10835 10772 817 10666 
3 8 10666 10681 10689 10702 1378 10798 3424 10854 
1 7 10498 10499 10462 13315 4728 165 10298 
1 3 10319 10355 4728 
1 2 10319 10269 
1 15 10970 10991 2091 111 2903 11128 1979 476 11177 416 2693 11149 11124 302 3068 
2 17 815 9670 9710 1439 9798 9808 9836 1877 9921 4992 9970 10009 1019 10033 10077 10116 25 
2 9 1877 9833 1642 4135 9726 1248 9652 2836 404 
1 4 404 9623 3977 815 
2 4 404 3737 3672 9487 
1 15 3787 9209 4379 462 4659 9044 1070 8997 8946 8915 4609 8903 8865 4193 616 
1 5 616 8916 2927 4634 810 
1 14 9487 2569 9486 5128 9485 9503 9526 3281 9492 9472 9470 9491 9481 9450 
2 5 9602 9569 13291 4175 9609 
1 4 9639 9680 9718 9782 
1 4 807 2561 4497 9790 
1 5 9926 9901 9865 9840 1692 
1 9 10318 1948 106 10407 10445 10451 2 3932 10506 
1 6 9315 3426 9396 9421 9464 5128 
1 5 1776 9387 9360 3711 1016 
2 8 1411 3738 9430 754 9529 4376 1498 997 
1 5 9328 9337 9361 4083 9348 
1 5 9348 1534 9269 9239 9198 
1 2 9497 2292 
1 4 1708 4796 9504 2292 
1 6 706 8493 1347 8597 8656 8713 
2 3 4291 2238 2828 
3 15 5019 2894 9325 555 9292 970 3373 1411 9336 1016 9298 1230 9228 188 2584 
2 8 5019 9358 1827 3473 862 9257 5099 186 
1 7 9490 662 9461 4241 2908 9377 1827 
1 7 186 9237 5143 9156 9121 4224 810 
1 6 1623 4415 4635 2180 8566 812 
1 9 812 8557 615 1116 2364 8781 8828 8846 616 
1 4 423 10608 10611 10575 
1 8 10922 13324 10855 10839 13318 10707 10667 10594 
1 7 2212 10914 1219 3865 10988 3158 10922 
1 2 10988 11026 
1 7 10981 10967 11005 4243 4273 10953 2738 
1 3 3141 4527 1159 
1 6 12477 5214 12434 1104 12404 921 
1 6 1159 12415 2246 1296 12425 908 
1 7 4445 12498 292 12476 12456 1482 1159 
1 6 1967 3785 12256 3655 12238 2027 
2 2 12262 1769 
1 4 12516 3951 12518 2407 
1 5 4841 12428 2761 12427 2032 
1 3 1694 5024 4781 
1 5 12493 12494 12474 12459 1694 
1 4 3438 4337 3638 12013 
3 10 12035 3000 4844 12071 1890 821 12101 12125 843 12140 
3 4 10970 10985 1568 10927 
1 11 609 10715 10665 10649 10607 798 4772 10488 4557 10469 10438 
1 4 1846 11203 11178 2903 
