2 8 2095 81 4265 4253 2006 779 2493 4252 
3 7 277 4327 2017 4374 2055 4379 4357 
2 3 4446 2241 2017 
1 14 4938 753 5002 5008 5033 5058 5085 1245 5129 5157 841 5233 2481 377 
1 11 2736 873 2568 4641 4673 545 4698 23 2071 4807 6410 
1 8 4977 4964 4943 1307 2370 312 4848 4834 
1 7 5157 1925 5206 2564 5185 1570 53 
1 4 1269 2153 5126 1570 
1 3 5157 5164 1263 
1 8 4962 4978 4988 2239 2539 5053 2156 1269 
1 5 4977 2171 323 5142 223 
3 11 1075 4468 4438 2439 4363 6404 2513 2644 1596 2041 4252 
2 9 2264 2362 2272 381 2737 3983 3990 1524 3921 
1 9 1952 1405 4135 4105 1936 4060 1857 4018 4024 
1 7 692 878 48 528 2251 3582 3562 
2 5 2272 1748 2311 4218 4252 
2 5 2039 2812 1608 2591 2264 
1 5 4763 1037 4678 2382 4607 
1 11 762 2821 4355 2202 4365 4362 1533 1659 4440 2507 1568 
1 7 1568 4518 2434 4581 1921 4580 4598 
1 8 2744 4720 4686 2170 2480 144 4557 1568 
2 5 1075 4502 1886 2665 4610 
1 9 1886 4547 4533 1351 4550 4575 4583 4582 4607 
1 6 762 4442 4475 4506 1844 4607 
1 4 4045 4073 4076 2272 
1 6 1952 1694 4132 4102 4072 4045 
2 7 2039 2024 3675 1971 3618 3597 3601 
1 11 3516 3548 3575 3598 1762 1672 3740 157 1249 265 3885 
1 8 3539 1963 3594 3621 3643 1384 3706 3740 
1 7 1729 3840 1271 2546 3718 3676 3643 
2 13 3601 2147 3566 3544 783 3480 2722 3417 2794 3381 3520 1431 788 
2 10 788 3258 6390 1671 3217 517 2652 3207 3220 2398 
1 10 3520 2049 3346 3362 2152 5 1962 3341 3351 3348 
1 10 3348 3322 2155 3254 3241 3222 1922 3223 3239 3228 
1 6 692 536 3619 3591 1230 3530 
1 4 1334 2286 3711 3727 
1 9 692 3765 3789 3752 3751 1238 3716 3670 3642 
2 9 2398 3215 3225 3243 3246 3247 3252 2274 2589 
3 14 2589 2069 3197 1939 2094 1235 3140 1912 2173 3115 890 3105 3091 3071 
1 6 1064 3185 2085 1753 1491 3197 
1 6 1064 3151 1127 3145 3144 1466 
2 9 2652 2425 3148 2211 3110 3092 3074 3059 1074 
1 5 1172 2335 2294 1853 1074 
1 16 1912 3130 2536 3080 2320 3036 3024 1910 6389 2415 3004 2791 1003 2968 1814 2960 
1 5 2415 3010 2456 2963 6388 
1 9 2014 3106 3119 1505 3127 3136 1588 3175 3194 
1 6 3194 3200 2185 1662 3166 1235 
1 5 37 3249 2008 1056 3197 
1 4 3240 2107 3253 37 
1 4 37 3295 3311 3300 
1 5 1417 3321 1879 3296 37 
1 11 1417 1427 3350 3370 2542 3379 2307 1782 1754 1583 3278 
2 5 4126 4077 1424 3990 1524 
1 7 3516 2275 3439 3412 2497 2253 2601 
1 6 788 2800 3294 3292 3309 2601 
1 6 4126 4156 4144 4172 2095 4173 
1 6 2983 3039 3054 874 3098 861 
1 11 7329 7315 7304 7291 7278 7268 7264 7257 7251 7243 7238 
1 12 7356 7339 7332 7317 7316 7310 7299 7281 7283 7269 7262 7264 
1 12 7304 7305 7319 7326 7336 7337 1393 7347 7345 7360 7358 7356 
1 7 1451 1526 1550 1593 7307 7324 7329 
1 14 7329 7342 1044 7367 7392 7407 7433 7454 7467 7476 7499 7516 7541 7553 
1 3 7454 7457 7451 
1 10 7553 7527 2118 1941 7583 7596 7603 7611 7615 2322 
1 11 7527 7509 7485 7478 7458 7428 7411 7397 7380 7386 7406 
1 8 7512 7490 7463 7442 7420 7402 7376 7356 
1 7 7406 7414 7418 7430 7432 7443 7442 
1 12 7527 7532 7537 7528 7554 7557 7563 7561 7546 7543 7539 7512 
